11111111111111111111111111111111
1001C000000000000000000000000011
100100000100000010001C0000000101
10010000001000001010001000001001
10010000000100001000000100010001
10010000000010000000000000100001
100000000000010000000C0001000001
1000000C000000100000000010000001
10000000000000E10000000100000001
10010000000000P00000000000000001
1001000000000000010001000C000001
1001000C000000000010100000000001
10010000000000000001000000000001
10000000000000000000100000000001
100000000000000000100010000C0001
10010000C00000001000000100000001
10010000000000100000000010000001
11111111111111111111111111111111