111111111111111111
1000000000000000011
10000P000000000001
10000000000C000001
100000E00000000001
111111111111111111