111111111111111111
1P10001000000000E1
101010100000000001
1010101000000C0001
10000000C000000001
111111111111111111