111111111111111111
100000000000000001
1000000P00E0000001
100000100001000001
100000000000000001
111111111111111111