11111111111111111111111111111111
1001C00000C0000B000000B000000011
100100000100000010001C0000000101
100100C0001000001010001000001001
100100C00C0100001000000100010001
10010000000010000000000000100001
100000000000010000000C0001000001
1000000C000000100000000010000001
100000000000C0E10000000100000001
10010000000000P00000000000000001
10010000000B0000010001000C000001
1001000C0000000000101000C000B001
100100000C0000000001000000000001
100000000C000000B00010C00C000001
1000B0000CBC000000100010000C0001
1001000BC010000010000001B0000001
10010001001000100000B00010000001
11111111111111111111111111111111