11111111111111111111111111111111
1001C00000B0000B000000B000000011
100100000100000010001C0000000101
100100B0001000001010001000001001
100100B00B0100001000000100010001
10010000000010000000000000100001
100000000000010000000C0001000001
1000000CB00000100000000010000001
100000000000B0E10000000100000001
10010000000000P00000000000000001
10010000000B0000010001000C000001
1001000C000000000010100000000001
100100000B0000000001000000000001
100000000B000000B000100000000001
1000B0000B0B000000100010000C0001
10010000C00000001000000100000001
10010B0000B000100000B00010000001
11111111111111111111111111111111
