1111111111111111111111111111111111
1E0000000B00B00C00000C0000B0000001
1010010100100000101001000000010101
1010010010101010001001000000010101
1P0000B00C00C000B000B00000B00000C1
1111111111111111111111111111111111