111111111111111111111111111111111111
1EB0C0000B00B00C00000C0000B000000001
101CC10100100000101001BCCB0001010B01
1010010010101010001001B0C00C01010B01
1P0000B00C00C000B000B0C000B00B0000C1
1B10C101001B0C0B10100100000001010CB1
101CC1010010BC0C10100100CB000101CB01
111111111111111111111111111111111111