111111111111111111111111111111111111
1EB0C0000B00B00C00000C00000000000001
101CC101001000001010010CCB0001010001
101001001010101000100100C00C01010B01
1P0000B00C00C000B000B0C00000000000C1
1010C101001B0C0B10100100000001010C01
101CC10100100C0C10100100C0000101C001
111111111111111111111111111111111111