1111111111111111111111111
1PEC000000100000000010001
1000000000B00000000010001
1000000000100000000010001
100CCC00000000000CCC10001
100CCC00000000000CCC10001
100CCC00001000000CCC10001
100CCC0B0010B0000CCCB0001
100000000000000000B000B01
1000B00000B000000CCC00101
10000000000000000CCC00101
100CCC0C001010000CCC00101
100CCC01001010000CCC00101
100CCC01CCCC1000000000101
1111111111111111111111111