1111111111111111111111111111111111
1E000B0000B000C010000000B000B00001
1010C101001000B0101001000000010101
1010010010101010001001000100010101
100000C000000000B00B00001000000001
1001010101010101010001C00000000001
100000000010001010000000C000010001
1000000000010000100C00000010000001
10000C0000001000B00000000100000001
10000B0000B00000000000000100000001
100001B0010010000B00010100001010B1
1P1000C000C000001000100001000000E1
1111111111111111111111111111111111