111111111111111111
100000000000000001
1000000E00C0000001
100000P00000000001
100000000000000001
111111111111111110