1111111111111111111111111111111111
1E000000000000C0100000000000000001
1010C10100100000101001000000010101
1010010010101010001001000100010101
100000C000000000000000001000000001
1001010101010101010001C00000000001
100000000010001010000000C000010001
1000000000010000100C00000010000001
1000000000001000000000000100000001
1000000000000000000000000100000001
1000010001001000000001010000101001
1P1000C0000000001000100001000000E1
1111111111111111111111111111111111